Input amount of players 
Input the name of player 
please input 2, 3, or 4 players 
The player obtaining the highest sum, will start the game 
push enter to roll the dice 
your throw equals another throw. Please throw again 
starts 
you are now on the 
field
Chancecard2			Move to Start and recieve 200kr
Chancecard3			Move to the Deposit Cash field
Chancecard4			Move to Bowlingcentre
Chancecard5			Move to Loose Money field
Chancecard6			You lose 500kr
Chancecard7			You recieve 500kr
Chancecard8			You lose 100kr
Chancecard9			You recieve 50kr
Chancecard10		Move 2 fields backwards
Chancecard11		Extra turn
Chancecard12		Nothing happens

Inputs:
Yes	Yes
No	No





AmusementFieldCinema		You are now on the Cinema field
AmusementFieldPizzaria		You are now on the Pizzaria field
AmusementFieldMuseum		You are now on the Museum field
AmusementFieldTivoli		You are now on the Tivoli field
AmusementFieldCasino		You are now on the Casino field
AmusementFieldZoo		You are now on the Zoo field
AmusementFieldWaterpark	You are now on the Waterpark field
AmusementFieldBowlingcentre	You are now on the Bowlingcentre field
BuyCinema			Do you want to buy Cinema for 200kr? Write yes or no
BuyPizzaria			Do you want to buy Pizzaria for 200kr? Write yes or no
BuyMuseum			Do you want to buy Museum for 300kr? Write yes or no
BuyTivoli			Do you want to buy Tivoli for 300kr? Write yes or no
BuyCasino			Do you want to buy Casino for 400kr? Write yes or no
BuyZoo			Do you want to buy Zoo for 400kr? Write yes or no
BuyWaterpark		Do you want to buy Waterpark for 500kr? Write yes or no
BuyBowlingcentre	Do you want to buy Bowlingcentre for 500kr? Write yes or no

Balance 			Your balance is now x
LooseMoneyFieldEmpty	You are on the Loose Money field. Unfortunately the field is empty.

LooseMoneyField		You recieve x kr
Railway			You get an extra hit
ChanceField			You are on the CHANCE? Field
DepositCashField	You are on the Deposit Cash field. 200kr are being deposited from your balance

RentCinema	The field is owned by another player. 200kr rent has been deducted from your account.

RentPizzaria		The field is owned by another player. 200kr rent has been deducted from your account.

RentMuseum		The field is owned by another player. 300kr rent has been deducted from your account.

RentTivoli		The field is owned by another player. 300kr rent has been deducted from your account.

RentCasino		The field is owned by another player. 400kr rent has been deducted from your account.

RentZoo		The field is owned by another player. 400kr rent has been deducted from your account.

RentWaterpark		The field is owned by another player. 500kr rent has been deducted from your account.

RentBowlingcentre		The field is owned by another player. 500kr rent has been deducted from your account.

